0 1 1 1 1 1 0
1 1 20 0 0 1 1
1 0 0 1 0 0 1
1 0 10 12 10 0 1
1 0 0 2 0 0 1
1 1 0 2 0 1 1
0 1 1 1 1 1 0